|-|-----------------------------------------------|
|.|..........|....................................|
|..|....---..|..---...|...|.-------------------...|
|..|....|....|..|.....|...|.|..................|..|
|..|....|....|...|----..--|..----|---....----..|..|
|..|.....--...|..|...|.....|......|..........|.|..|
|.|---....|..|......|--|..|---|...|..........|.|..|
|.........|.....|..|.....|...-|...|..........|.|..|
|-----|..-|.....|--|....|--|....|..----------|.|..|
|.....|..|..............|..|....|..............|..|
|..|--|..|..----------..|..|....|--------------|..|
|........|..|........|............................|
|--------|--|--------|----------------------------|
